"a" = (/turf,/area)
"b" = (/turf,/turf,/area)

(1,1,1) = {"
aaaaaaaaaa
aaaaaaaaaa
aaaaaaaaaa
aaaaaaaaaa
aaaaaaaaaa
aaaaaaaaaa
aabaaaaaaa
aaaaaaaaaa
aaaaaaaaaa
aaaaaaaaaa
"}
